1111111111111
1P000000000C1
1000000000001
10000000000E1
1000000000101
10000000001C1
1111111111111
