111111111111
100000010C01
101111010C01
1000P1C001E1
111111111111
