111111111111
1P0000010001
111011010001
1C10010001E1
111111111111
