111111111111
10P000010001
111011010001
1C00010001E1
111111111111
