111111111111
1P0000C000E1
111111111111
