11111111111111111111111111111111111111111111111
1000E0000000000C0000CC00000000000C0000000C01111
100000000000000C0000CC00000000000C0000000C01111
100000000000000C0000CC00000000000C0000000C01111
100000000000000C0000CC00000000000C0000000C01111
100000000000000C0000CC00000000000C0000P00C01111
100000000000000C0000CC00000000000C0000000C01111
100000000000000C0000CC00000000000C0000000C01111
11111111111111111111111111111111111111111111111
