11111
11101
111C1
11EP1
11111
