11111111111111
1P0000000C0001
100C0000000001
10000000000000
10100000000001
1C100000C000E1
11111111111111