11111111111111
1P000000000001
10000000000001
10000000000001
10100000000001
101000000000E1
11111111111111