11111111111111
1P0000000C00P1
100C0000000001
10000000000001
10100000000001
1C100000C000E1
11111111111111