11111111111111
1P0000000C0001
100C0000000001
10000000000001
10100000000011
1C100000C001E1
11111111111111