1111111111111
00010000000C1
0000011111001
1P0011E000001
1111111111111
