11111111111111111
00010000000C1111
000001111100111
1P0011E0000011
1111111111111
